-------------
-------------
-------------
-------------
g-r-b-m-y-w-o
s-s-s-s-s-s-s
-b-r-g-c-o-w-
-s-s-s-s-s-s-
c-g-r-b-m-y-w
s-s-s-s-s-s-s
-m-b-r-g-c-o-
-s-s-s-s-s-s-
o-c-g-r-b-m-y
s-s-s-s-s-s-s
-y-m-b-r-g-c-
-s-s-s-s-s-s-
w-o-c-g-r-b-m
s-s-s-s-s-s-s