-------------
-------------
-------------
-------------
b-r-g-c-g-r-b
b-r-g-c-g-r-b
b-r-g-c-g-r-b
b-r-g-c-g-r-b
b-r-g-c-g-r-b
b-GoGoGoGoG-b
b-r-g-c-g-r-b
b-r-g-c-g-r-b
b-r-g-c-g-r-b
b-r-g-c-g-r-b
o-o-G-o-G-o-o
b-r-g-c-g-r-b
-------------
-------------