-------------
-------------
-------------
-------------
-yyy-www-yyy-
-mmm-ooo-mmm-
-bbb-ccc-bbb-
-rrr-ggg-rrr-
-ggg-rrr-ggg-
-ccc-bbb-ccc-
-ooo-mmm-ooo-
-www-yyy-www-
-------------
-------------
-------------
-------------
-------------
-------------