-------------
-------------
-------------
-------------
rrrrrrrrrrrrr
ggggggggggggg
bbbbbbbbbbbbb
GGGGGsssGGGGG
GrrrG---GbbbG
GrrrG---GbbbG
G-----------G
G-----------G
G---GgggG---G
G---GgggG---G
GsssGGGGGsssG
-------------
-------------
-------------