-------------
-------------
-------------
-------------
------G------
----ww-ww----
--ww--G--ww--
ww--oo-oo--ww
--oo--G--oo--
oo--yy-yy--oo
--yy--G--yy--
yy--gg-gg--yy
--gg--G--gg--
gg--rr-rr--gg
--rr--G--rr--
rr--bb-bb--rr
--bb-----bb--
bb---------bb