-------------
-------------
-------------
-------------
-GoooooooooG-
-G---------G-
-G-GGGGGGG-G-
-G-G-----G-G-
-G-G-----G-G-
-G-G-rrr-G-G-
-G-G-ggg-G-G-
-G-G-bbb-G-G-
-G-G-www-G-G-
-G-G-----G-G-
-G-GcccccG-G-
-G---------G-
-G---------G-
-GGGGGGGGGGG-