0000000000000
0000000000000
0000000000000
ggggggggggggg
0000000000000
wwwGGGGGGGGGG
0000000000000
rrrrrrrrrrrrr
0000000000000
GGGGGGGGGGwww
0000000000000
mmmmmmmmmmmmm
0000000000000
bbbGGGGGGGGGG
0000000000000
ccccccccccccc
0000000000000
GGGGGGGGGGccc