-------------
-------------
-------------
-------------
o-G-------G-o
o-GG-----GG-o
o-G-G---G-G-o
o-G-mG-Gc-G-o
o-G-m-s-c-G-o
o-G-m-g-c-G-o
o-G-m-g-c-G-o
o-G-m-g-c-G-o
o-G-m-g-c-G-o
oGGGm-g-cGGGo
-------------
-------------
-------------
-------------