-------------
-------------
-------------
-------------
GwGoGcGgGrGbG
GmGsGsGsGsGyG
-------------
GmG-G-G-G-G-G
G-GmG-G-G-G-G
G-G-GmG-G-G-G
G-G-G-GmG-G-G
G-G-G-G-GmG-G
-----------m-
--G-G-G-GmG--
--G-G-GmG-G--
--G-GmG-G-G--
---mG-G-G----
-m----G------