-G-----------
-------------
-G-----------
-G-----------
-G-----------
-G-----b-----
-G----bcb----
-G---bcwcb---
-G--bcwcwcb--
-G-bcwcscwcb-
-G--bcwcwcb--
-G---bcwcb---
-G----bcb----
-G-----b-----
-G-----------
-G-----------
-G-----------
-GGGGGGGGGGGG