-------------
-------------
-------------
-------------
--G-G-G---G--
--G-G-G---G--
--G-G-G--gg--
--G-G-G---G--
--G-G-Grrrr--
--G-G-G---G--
--G-Gbbbbbb--
--G-G-G---G--
--Gmmmmmmmm--
--G-G-G-G-G--
--yyyyyyyyy--
--sssssssss--
-------------
-------------