-------------
-------------
-------------
bbbbbbbbbbbbb
bGGGGmGmGGGGb
bG---------Gb
bGm-------mGb
bGmm-----mmGb
bGmmm---mmmGb
-bGmmm-mmmGb-
--bGmmmmmGb--
---bGmmmGb---
----bGmGb----
-----bmb-----
------b------
-------------
-------------
-------------