-------------
-------------
-G-G-----G-G-
-GgG-----GgG-
-GcG-----GcG-
-GGG-----GGG-
-------------
----mwwwy----
----moooy----
----mcccy----
----mgggy----
----mrrry----
----mbbby----
-------------
-------------
-------------
-------------
-------------