-------------
-------------
-------------
-------------
------s------
---bbbsggg---
--bbbwwwggg--
--bbwwwwwgg--
-bbbwwwwwggg-
-bbbwwwwwggg-
-bbbwwwwwggg-
-s--s-s-s--s-
------s------
------s------
------s------
----G-G------
----GGG------
-----G-------