-------------
-------------
-------------
-------------
--GsssG------
-G-----G-----
G--ccc--G----
G-ggggg-G----
G-bbbbb-G----
G--mmm--G----
-G-----G-----
--GGGGG------
-------------
-------------
-------------
-------------
-------------
-------------