-------------
-------------
-------------
-------------
GGGGGGGGGGGGG
----G-----Gm-
-Gw-G-----G--
-G--G--G--G--
-G--Gg-G--G--
-G--G--G--G--
-G-oG--G-bG--
-G--G--G--G--
-G--G--G--G--
-G--G-rG--G--
-G--G--G--G--
-Gc----G-----
-G-----G----y
-GGGGGGGGGGGG